=======
1X1X1X1
X1X1X1X
XXXXXXX
11XXX11
======
1XXXX1
X1111X
XXXXXX