=======
12RRR21
1333331
12RRR21
12RRR21
===
111
RRR
-------4
11XXX11
XX222XX