=======
11SRS11
1111111
11SRS11
11SRS11
=======
XXSSSXX
XX111XX