=======
1UUUUU1
1233312
21PV312
PMHSH1P
XXXRH1M
1XX2XX1
XX2X2XX
X1X1X1X
11XXX11
======
1XXXX1
X1111X
1X11X1
=
1
1