=======
12RRR21
1333331
12RRR21
12RRR21
=======
XX111XX
XXRRRXX
=======
12RRR21
1333331
12RRR21
12RRR21
=======
XX111XX
XXRRRXX
11XXX11
XX222XX
-------7
11XXX11
XX222XX