=======
22RRR22
3333333
12RRR21
33RRR33
===
XX222XX
XXRRRXX
=======
12RRR21
1333331
12RRR21
12RRR21
-------4
11XXX11
XX222XX